[layout]

0,0,0,0,0,0,0,0,0,0,0,0,0,0,0,0
0,1,1,1,1,1,1,1,1,0,1,1,1,1,1,0
0,1,1,1,1,1,1,1,1,1,1,1,1,1,1,0
0,1,1,1,1,1,1,1,1,0,1,1,1,1,1,0
0,1,1,1,1,1,1,1,1,0,1,1,1,1,1,0
0,1,1,1,1,1,1,1,1,0,0,0,1,0,0,0
0,1,1,1,1,1,1,1,1,0,0,0,1,0,0,0
0,1,1,1,1,1,1,1,1,0,1,1,1,1,1,0
0,1,1,1,1,1,1,1,1,0,1,1,1,1,1,0
0,1,1,1,1,1,1,1,1,1,1,1,1,1,1,0
0,1,1,1,1,1,1,1,1,0,1,1,1,1,1,0
0,0,0,0,0,0,0,0,0,0,0,0,0,0,0,0

[entity]
p_,1,5
patrol,goblin,8,1,8,10
AI,magmatrum,12,2
AI,magmatrum,12,8
